
WWWWWWWWWWWWWWWWWWWWWWWWWWWWWWWWW
W-------U---------------U-------W
W-WWWWWW-W-WWWWWWWWWWW-W-WWWWWW-W
W---U----W------W------W----U---W
WWWWWWWW-WWWWWW-W-WWWWWW-WWWWWWWW
       W-W--U-------U--W-W
WWWWWWWW-W-WWWTTTTTWWW-W-WWWWWWWW
W----------W         W----------W
WWWWWWWW-W-W B  I  C W-W-WWWWWWWW
W----------W         W----------W
WWWWWWWW-W-WWWWWWWWWWW-W-WWWWWWWW
       W-W--U-------U--W-W
WWWWWWWW-WWWWWW-W-WWWWWW-WWWWWWWW
W---U----WP-----W------W----U---W
W-WWWWWW-W-WWWWWWWWWWW-W-WWWWWW-W
W-------U---------------U-------W
WWWWWWWWWWWWWWWWWWWWWWWWWWWWWWWWW